11111111
101C10E1
1PC00101
100000C1
10Z000C1
11111111
