11111111
101C10C1
1PC000E1
100100C1
10Z000C1
1CC0C1C1
11111111
