111111111
1C01000C1
1C1001CC1
1P1000001
1000C10E1
111111111
