111111111
1P1000C01
10P010001
1CC1CCEC1
1CCCCCCC1
111111111
