111111111
1C1000C01
1C00C0CC1
1P1010001
1C0001CE1
111111111
