111111111
1C1000C01
10P110001
1CC1CCEC1
1C0CCCCC1
1010010C1
111111111
