111111111111111
100000C0000C001
100C0000P0C0001
11C1110C0011111
1E00000C0011111
111111111111111
