11111111111111
10101C1CC11111
1P00C0C1C01111
100C00C0C00111
10000000CC00E1
11111111111111
