11111111
100000C1
100P0001
1000C001
1E0000C1
11111111
