111111111
1EC0C1CC1
1C00010E1
1C00P0C01
111111111
